13 13 13 13 13 13 13 13 13 13 13 13 13 13 13 13 13 13 13 13 13 13 13 13 13 13 13 13 13 13 13 13 13 13 13 13 13 13 13 13 13 13 13 13 13 13 13 13 13 13 13 13 13 13 13 13 13 13 13 13 13 13 13 13 13 13 13 13 13 13 13 13 13 13 13 13 13 13 13 13 11 11 11 11 11 11 11 11 11 11 11 11 11 11 11 11 11 11 11 11
13 11 11 11 11 11 11 11 11 11 11 11 11 11 11 11 11 11 11 11 11 11 11 11 11 11 11 11 11 11 11 11 11 11 11 11 11 11 11 11 11 11 11 11 11 11 11 11 11 11 11 11 11 11 11 11 11 11 11 11 11 11 11 11 11 11 11 11 11 11 11 11 11 11 11 11 11 11 11 11 11 16 16 16 16 16 16 16 16 16 16 16 16 16 16 16 16 16 16 11
13 11 14 14 14 14 14 14 14 14 14 14 14 14 14 14 14 14 14 14 14 14 14 14 14 14 14 14 14 14 14 14 14 14 14 14 14 14 14 14 14 14 14 14 14 14 14 14 14 14 14 14 14 14 14 14 14 14 14 14 14 14 14 14 14 14 14 14 14 14 14 14 14 14 14 14 14 14 14 14 16 16 16 16 16 16 16 16 16 16 16 16 16 16 16 16 16 16 16 11
13 11 14 14 14 14 14 14 14 14 14 14 14 14 14 14 14 14 14 14 14 14 14 14 14 14 14 14 14 14 14 14 14 14 14 14 14 14 14 14 14 14 14 14 14 14 14 14 14 14 14 14 14 14 14 14 14 14 14 14 14 14 14 14 14 14 14 14 14 14 14 14 14 14 14 14 14 14 14 14 16 16 16 16 16 16 16 16 16 16 16 16 16 16 16 16 16 16 16 11
13 11 14 14 14 14 14 14 14 14 14 14 14 14 14 14 14 14 14 14 14 14 14 14 14 14 14 14 14 14 14 14 14 14 14 14 14 14 14 14 14 14 14 14 14 14 14 14 14 14 14 14 14 14 14 14 14 14 14 14 14 14 14 14 14 14 14 14 14 14 14 14 14 14 14 14 14 14 14 14 16 16 16 16 16 16 16 16 16 16 16 16 16 16 16 16 16 16 16 11
13 11 14 14 14 14 14 14 14 14 14 14 14 14 14 14 14 14 14 14 14 14 14 14 14 14 14 14 14 14 14 14 14 14 14 14 14 14 14 14 14 14 14 14 14 14 14 14 14 14 14 14 14 14 14 14 14 14 14 14 14 14 14 14 14 14 14 14 14 14 14 14 14 14 14 14 14 14 14 14 16 16 16 16 16 16 16 16 16 16 16 16 16 16 16 16 16 16 16 11
13 11 14 14 14 14 14 14 14 14 14 14 14 14 14 14 14 14 14 14 14 14 14 14 14 14 14 14 14 14 14 14 14 14 14 14 14 14 14 14 14 14 14 14 14 14 14 14 14 14 14 14 14 14 14 14 14 14 14 14 14 14 14 14 14 14 14 14 14 14 14 14 14 14 14 14 14 14 14 14 16 16 16 16 16 16 16 16 16 16 16 16 16 16 16 16 16 16 16 11
13 11 14 14 14 14 14 14 14 14 14 14 14 14 14 14 14 14 14 14 14 14 14 14 14 14 14 14 14 14 14 14 14 14 14 14 14 14 14 14 14 14 14 14 14 14 14 14 14 14 14 14 14 14 14 14 14 14 14 14 14 14 14 14 14 14 14 14 14 14 14 14 14 14 14 14 14 14 14 14 16 16 16 16 16 16 16 16 16 16 16 16 16 16 16 16 16 16 16 11
13 11 14 14 14 14 14 14 14 14 14 14 14 14 14 14 14 14 14 14 14 14 14 14 14 14 14 14 14 14 14 14 14 14 14 14 14 14 14 14 14 14 14 14 14 14 14 14 14 14 14 14 14 14 14 14 14 14 14 14 14 14 14 14 14 14 14 14 14 14 14 14 14 14 14 14 14 14 14 14 16 16 16 16 16 16 16 16 16 16 16 16 16 16 16 16 16 16 16 11
13 11 14 14 14 14 14 14 14 14 14 14 14 14 14 14 14 14 14 14 14 14 14 14 14 14 14 14 14 14 14 14 14 14 14 14 14 14 14 14 14 14 14 14 14 14 14 14 14 14 14 14 14 14 14 14 14 14 14 14 14 14 14 14 14 14 14 14 14 14 14 14 14 14 14 14 14 14 14 14 16 16 16 16 16 16 16 16 16 16 16 16 16 16 16 16 16 16 16 11
13 11 14 14 14 14 14 14 14 14 12 12 12 18 11 11 11 11 11 11 11 11 11 11 11 11 11 11 11 11 11 11 11 11 11 11 11 11 11 11 11 11 11 11 11 11 11 11 11 11 11 11 11 11 11 11 11 11 11 11 11 11 11 11 11 11 11 11 11 11 11 11 11 11 11 11 11 11 11 11 11 16 16 16 16 16 16 16 16 16 16 16 16 16 16 16 16 16 16 11
13 11 14 14 14 14 14 14 14 14 12 12 12 20 18 13 13 13 13 13 13 13 13 13 13 13 13 13 13 13 13 13 13 13 13 13 13 13 13 13 13 13 13 13 13 13 13 13 13 13 13 13 13 13 13 13 13 13 13 13 13 13 13 13 13 13 13 13 13 13 13 13 13 13 13 13 13 13 13 13 11 16 16 16 16 16 16 16 16 16 16 16 16 16 16 16 16 16 16 11
13 11 14 14 14 14 14 14 14 14 12 12 12 12 20 18 10 10 10 10 10 10 10 10 10 10 10 10 10 10 10 10 10 10 10 10 10 10 10 10 10 10 10 10 10 10 10 10 10 10 10 10 10 10 10 10 10 10 10 10 10 10 10 10 10 10 10 10 10 10 10 10 10 10 10 10 10 10 10 13 11 16 16 16 16 16 16 16 16 16 16 16 16 16 16 16 16 16 16 11
13 11 14 14 14 14 14 14 14 14 19 21 12 12 12 20 18 10 10 10 10 10 10 10 10 10 10 10 10 10 10 10 10 10 10 10 10 10 10 10 10 10 10 10 10 10 10 10 10 10 10 10 10 10 10 10 10 10 10 10 10 10 10 10 10 10 10 10 10 10 10 10 10 10 10 10 10 10 10 13 11 16 16 16 16 16 16 16 16 16 16 16 16 16 16 16 16 16 16 11
13 11 14 14 14 14 14 14 14 14 11 19 21 12 12 12 20 18 10 10 10 10 10 10 10 10 10 10 10 10 10 10 10 10 10 10 10 10 10 10 10 10 10 10 10 10 10 10 10 10 10 10 10 10 10 10 10 10 10 10 10 10 10 10 10 10 10 10 10 10 10 10 10 10 10 10 10 10 10 13 11 16 16 16 16 16 16 16 16 16 16 16 16 16 16 16 16 16 16 11
13 11 14 14 14 14 14 14 14 14 11 13 19 21 12 12 12 20 18 10 10 10 10 10 10 10 10 10 10 10 10 10 10 10 10 10 10 10 10 10 10 10 10 10 10 10 10 10 10 10 10 10 10 10 10 10 10 10 10 10 10 10 10 10 10 10 10 10 10 10 10 10 10 10 10 10 10 10 10 13 11 16 16 16 16 16 16 16 16 16 16 16 16 16 16 16 16 16 16 11
13 11 14 14 14 14 14 14 14 14 11 13 10 19 21 12 12 12 20 18 10 10 10 10 10 10 10 10 10 10 10 10 10 10 10 10 10 10 10 10 10 10 10 10 10 10 10 10 10 10 10 10 10 10 10 10 10 10 10 10 10 10 10 10 10 10 10 10 10 10 10 10 10 10 10 10 10 10 10 13 11 16 16 16 16 16 16 16 16 16 16 16 16 16 16 16 16 16 16 11
13 11 14 14 14 14 14 14 14 14 11 13 10 10 19 21 12 12 12 20 18 10 10 10 10 10 10 10 10 10 10 10 10 10 10 10 10 10 10 10 10 10 10 10 10 10 10 10 10 10 10 10 10 10 10 10 10 10 10 10 10 10 10 10 10 10 10 10 10 10 10 10 10 10 10 10 10 10 10 11 14 16 16 16 16 16 16 16 16 16 16 16 16 16 16 16 16 16 16 11
13 11 14 14 14 14 14 14 14 14 11 13 10 10 10 19 21 12 12 12 20 18 10 10 10 10 10 10 10 10 10 10 10 10 10 10 10 10 10 10 10 10 10 10 10 10 10 10 10 10 10 10 10 10 10 10 10 10 10 10 10 10 10 10 10 10 10 10 10 10 10 10 10 10 10 10 10 10 11 14 14 16 16 16 16 16 16 16 16 16 16 16 16 16 16 16 16 16 16 11
13 11 14 14 14 14 14 14 14 14 11 13 10 10 10 10 19 21 12 12 12 20 18 10 10 10 10 10 10 10 10 10 10 10 10 10 10 10 10 10 10 10 10 10 10 10 10 10 10 10 10 10 10 10 10 10 10 10 10 10 10 10 10 10 10 10 10 10 10 10 10 10 10 10 10 10 10 11 14 14 14 14 14 11 11 11 11 11 11 11 16 16 16 16 16 16 16 16 11 13
13 11 14 14 14 14 14 14 14 14 11 13 10 10 10 10 10 19 21 12 12 12 20 18 10 10 10 10 10 10 10 10 10 10 10 10 10 10 10 10 10 10 10 10 10 10 10 10 10 10 10 10 10 10 10 10 10 10 10 10 10 10 10 10 10 10 10 10 10 10 10 10 10 10 10 10 11 14 14 14 14 14 11 13 13 13 13 13 13 11 14 14 14 14 14 14 14 14 11 13
13 11 14 14 14 14 14 14 14 14 11 13 10 10 10 10 10 10 19 21 12 12 12 20 18 10 10 10 10 10 10 10 10 10 10 10 10 10 10 10 10 10 10 10 10 10 10 10 10 10 10 10 10 10 10 10 10 10 10 10 10 10 10 10 10 10 10 10 10 10 10 10 10 10 10 11 14 14 14 14 14 11 10 10 10 10 10 10 13 11 14 14 14 14 14 14 14 14 11 13
13 11 14 14 14 14 14 14 14 14 11 13 10 10 10 10 10 10 10 19 21 12 12 12 20 18 10 10 10 10 10 10 10 10 10 10 10 10 10 10 10 10 10 10 10 10 10 10 10 10 10 10 10 10 10 10 10 10 10 10 10 10 10 10 10 10 10 10 10 10 10 10 10 10 11 14 14 14 14 14 11 10 10 10 10 10 10 10 13 11 14 14 14 14 14 14 14 14 11 13
13 11 14 14 14 14 14 14 14 14 11 13 10 10 10 10 10 10 10 10 19 21 12 12 12 20 18 10 10 10 10 10 10 10 10 10 10 10 10 10 10 10 10 10 10 10 10 10 10 10 10 10 10 10 10 10 10 10 10 10 10 10 10 10 10 10 10 10 10 10 10 10 10 11 14 14 14 14 14 11 10 10 10 10 10 10 10 10 13 11 14 14 14 14 14 14 14 14 11 13
13 11 14 14 14 14 14 14 14 14 11 13 10 10 10 10 10 10 10 10 10 19 21 12 12 12 20 18 10 10 10 10 10 10 10 10 10 10 10 10 10 10 10 10 10 10 10 10 10 10 10 10 10 10 10 10 10 10 10 10 10 10 10 10 10 10 10 10 10 10 10 10 11 14 14 14 14 14 11 10 10 10 10 10 10 10 10 10 13 11 14 14 14 14 14 14 14 14 11 13
13 11 14 14 14 14 14 14 14 14 11 13 10 10 10 10 10 10 10 10 10 10 19 21 12 12 12 20 18 10 10 10 10 10 10 10 10 10 10 10 10 10 10 10 10 10 10 10 10 10 10 10 10 10 10 10 10 10 10 10 10 10 10 10 10 10 10 10 10 10 10 11 14 14 14 14 14 11 10 10 10 10 10 10 10 10 10 10 13 11 14 14 14 14 14 14 14 14 11 13
13 11 14 14 14 14 14 14 14 14 11 13 10 10 10 10 10 10 10 10 10 10 10 19 21 12 12 12 20 18 10 10 10 10 10 10 10 10 10 10 10 10 10 10 10 10 10 10 10 10 10 10 10 10 10 10 10 10 10 10 10 10 10 10 10 10 10 10 10 10 11 14 14 14 14 14 11 10 10 10 10 10 10 10 10 10 10 10 13 11 14 14 14 14 14 14 14 14 11 13
13 11 14 14 14 14 14 14 14 14 11 13 10 10 10 10 10 10 10 10 10 10 10 10 19 21 12 12 12 20 18 10 10 10 10 10 10 10 10 10 10 10 10 10 10 10 10 10 10 10 10 10 10 10 10 10 10 10 10 10 10 10 10 10 10 10 10 10 10 11 14 14 14 14 14 11 10 10 10 10 10 10 10 10 10 10 10 10 13 11 14 14 14 14 14 14 14 14 11 13
13 11 14 14 14 14 14 14 14 14 11 13 10 10 10 10 10 10 10 10 10 10 10 10 10 19 21 12 12 12 20 18 10 10 10 10 10 10 10 10 10 10 10 10 10 10 10 10 10 10 10 10 10 10 10 10 10 10 10 10 10 10 10 10 10 10 10 10 11 14 14 14 14 14 11 10 10 10 10 10 10 10 10 10 10 10 10 10 13 11 14 14 14 14 14 14 14 14 11 13
13 11 14 14 14 14 14 14 14 14 11 13 10 10 10 10 10 10 10 10 10 10 10 10 10 10 19 21 12 12 12 20 18 10 10 10 10 10 10 10 10 10 10 10 10 10 10 10 10 10 10 10 10 10 10 10 10 10 10 10 10 10 10 10 10 10 10 11 14 14 14 14 14 11 10 10 10 10 10 10 10 10 10 10 10 10 10 10 13 11 14 14 14 14 14 14 14 14 11 13
13 11 14 14 14 14 14 14 14 14 11 13 10 10 10 10 10 10 10 10 10 10 10 10 10 10 10 19 21 12 12 12 20 18 10 10 10 10 10 10 10 10 10 10 10 10 10 10 10 10 10 10 10 10 10 10 10 10 10 10 10 10 10 10 10 10 11 14 14 14 14 14 11 10 10 10 10 10 10 10 10 10 10 10 10 10 10 10 13 11 14 14 14 14 14 14 14 14 11 13
13 11 14 14 14 14 14 14 14 14 11 13 10 10 10 10 10 10 10 10 10 10 10 10 10 10 10 10 19 21 12 12 12 20 18 10 10 10 10 10 10 10 10 10 10 10 10 10 10 10 10 10 10 10 10 10 10 10 10 10 10 10 10 10 10 11 14 14 14 14 14 11 10 10 10 10 10 10 10 10 10 10 10 10 10 10 10 10 13 11 14 14 14 14 14 14 14 14 11 13
13 11 14 14 14 14 14 14 14 14 11 13 10 10 10 10 10 10 10 10 10 10 10 10 10 10 10 10 10 19 21 12 12 12 20 18 10 10 10 10 10 10 10 10 10 10 10 10 10 10 10 10 10 10 10 10 10 10 10 10 10 10 10 10 11 14 14 14 14 14 11 10 10 10 10 10 10 10 10 10 10 10 10 10 10 10 10 10 13 11 14 14 14 14 14 14 14 14 11 13
13 11 14 14 14 14 14 14 14 14 11 13 10 10 10 10 10 10 10 10 10 10 10 10 10 10 10 10 10 10 19 21 12 12 12 20 18 10 10 10 10 10 10 10 10 10 10 10 10 10 10 10 10 10 10 10 10 10 10 10 10 10 10 11 14 14 14 14 14 11 10 10 10 10 10 10 10 10 10 10 10 10 10 10 10 10 10 10 13 11 14 14 14 14 14 14 14 14 11 13
13 11 14 14 14 14 14 14 14 14 11 13 10 10 10 10 10 10 10 10 10 10 10 10 10 10 10 10 10 10 10 19 21 12 12 12 20 18 10 10 10 10 10 10 10 10 10 10 10 10 10 10 10 10 10 10 10 10 10 10 10 10 11 14 14 14 14 14 11 10 10 10 10 10 10 10 10 10 10 10 10 10 10 10 10 10 10 10 13 11 14 14 14 14 14 14 14 14 11 13
13 11 14 14 14 14 14 14 14 14 11 13 10 10 10 10 10 10 10 10 10 10 10 10 10 10 10 10 10 10 10 10 19 21 12 12 12 20 18 10 10 10 10 10 10 10 10 10 10 10 10 10 10 10 10 10 10 10 10 10 10 11 14 14 14 14 14 11 10 10 10 10 10 10 10 10 10 10 10 10 10 10 10 10 10 10 10 10 13 11 14 14 14 14 14 14 14 14 11 13
13 11 14 14 14 14 14 14 14 14 11 13 10 10 10 10 10 10 10 10 10 10 10 10 10 10 10 10 10 10 10 10 10 19 21 12 12 12 20 18 10 10 10 10 10 10 10 10 10 10 10 10 10 10 10 10 10 10 10 10 11 14 14 14 14 14 11 10 10 10 10 10 10 10 10 10 10 10 10 10 10 10 10 10 10 10 10 10 13 11 14 14 14 14 14 14 14 14 11 13
13 11 14 14 14 14 14 14 14 14 11 13 10 10 10 10 10 10 10 10 10 10 10 10 10 10 10 10 10 10 10 10 10 10 19 21 12 12 12 20 18 10 10 10 10 10 10 10 10 10 10 10 10 10 10 10 10 10 10 11 14 14 14 14 14 11 10 10 10 10 10 10 10 10 10 10 10 10 10 10 10 10 10 10 10 10 10 10 13 11 14 14 14 14 14 14 14 14 11 13
13 11 14 14 14 14 14 14 14 14 11 13 10 10 10 10 10 10 10 10 10 10 10 10 10 10 10 10 10 10 10 10 10 10 10 19 21 12 12 12 20 18 10 10 10 10 10 10 10 10 10 10 10 10 10 10 10 10 11 14 14 14 14 14 11 10 10 10 10 10 10 10 10 10 10 10 10 10 10 10 10 10 10 10 10 10 10 10 13 11 14 14 14 14 14 14 14 14 11 13
13 11 14 14 14 14 14 14 14 14 11 13 10 10 10 10 10 10 10 10 10 10 10 10 10 10 10 10 10 10 10 10 10 10 10 10 19 21 12 12 12 20 18 10 10 10 10 10 10 10 10 10 10 10 10 10 10 11 14 14 14 14 14 11 10 10 10 10 10 10 10 10 10 10 10 10 10 10 10 10 10 10 10 10 10 10 10 10 13 11 14 14 14 14 14 14 14 14 11 13
13 11 14 14 14 14 14 14 14 14 11 13 10 10 10 10 10 10 10 10 10 10 10 10 10 10 10 10 10 10 10 10 10 10 10 10 10 19 21 12 12 12 20 18 10 10 10 10 10 10 10 10 10 10 10 10 11 14 14 14 14 14 11 10 10 10 10 10 10 10 10 10 10 10 10 10 10 10 10 10 10 10 10 10 10 10 10 10 13 11 14 14 14 14 14 14 14 14 11 13
13 11 14 14 14 14 14 14 14 14 11 13 10 10 10 10 10 10 10 10 10 10 10 10 10 10 10 10 10 10 10 10 10 10 10 10 10 10 19 21 12 12 12 20 18 10 10 10 10 10 10 10 10 10 10 11 14 14 14 14 14 11 10 10 10 10 10 10 10 10 10 10 10 10 10 10 10 10 10 10 10 10 10 10 10 10 10 10 13 11 14 14 14 14 14 14 14 14 11 13
13 11 14 14 14 14 14 14 14 14 11 13 10 10 10 10 10 10 10 10 10 10 10 10 10 10 10 10 10 10 10 10 10 10 10 10 10 10 10 19 21 12 12 12 20 18 10 10 10 10 10 10 10 10 11 14 14 14 14 14 11 10 10 10 10 10 10 10 10 10 10 10 10 10 10 10 10 10 10 10 10 10 10 10 10 10 10 10 13 11 14 14 14 14 14 14 14 14 11 13
13 11 14 14 14 14 14 14 14 14 11 13 10 10 10 10 10 10 10 10 10 10 10 10 10 10 10 10 10 10 10 10 10 10 10 10 10 10 10 10 19 21 12 12 12 20 18 10 10 10 10 10 10 11 14 14 14 14 14 11 10 10 10 10 10 10 10 10 10 10 10 10 10 10 10 10 10 10 10 10 10 10 10 10 10 10 10 10 13 11 14 14 14 14 14 14 14 14 11 13
13 11 14 14 14 14 14 14 14 14 11 13 10 10 10 10 10 10 10 10 10 10 10 10 10 10 10 10 10 10 10 10 10 10 10 10 10 10 10 10 10 19 21 12 12 12 20 18 10 10 10 10 11 14 14 14 14 14 11 10 10 10 10 10 10 10 10 10 10 10 10 10 10 10 10 10 10 10 10 10 10 10 10 10 10 10 10 10 13 11 14 14 14 14 14 14 14 14 11 13
13 11 14 14 14 14 14 14 14 14 11 13 10 10 10 10 10 10 10 10 10 10 10 10 10 10 10 10 10 10 10 10 10 10 10 10 10 10 10 10 10 10 19 21 12 12 12 20 18 10 10 11 14 14 14 14 14 11 10 10 10 10 10 10 10 10 10 10 10 10 10 10 10 10 10 10 10 10 10 10 10 10 10 10 10 10 10 10 13 11 14 14 14 14 14 14 14 14 11 13
13 11 14 14 14 14 14 14 14 14 11 13 10 10 10 10 10 10 10 10 10 10 10 10 10 10 10 10 10 10 10 10 10 10 10 10 10 10 10 10 10 10 10 19 21 12 12 12 20 18 11 14 14 14 14 14 11 10 10 10 10 10 10 10 10 10 10 10 10 10 10 10 10 10 10 10 10 10 10 10 10 10 10 10 10 10 10 10 13 11 14 14 14 14 14 14 14 14 11 13
13 11 14 14 14 14 14 14 14 14 11 13 10 10 10 10 10 10 10 10 10 10 10 10 10 10 10 10 10 10 10 10 10 10 10 10 10 10 10 10 10 10 10 10 19 21 12 12 12 26 23 14 14 14 14 11 10 10 10 10 10 10 10 10 10 10 10 10 10 10 10 10 10 10 10 10 10 10 10 10 10 10 10 10 10 10 10 10 13 11 14 14 14 14 14 14 14 14 11 13
13 11 14 14 14 14 14 14 14 14 11 13 10 10 10 10 10 10 10 10 10 10 10 10 10 10 10 10 10 10 10 10 10 10 10 10 10 10 10 10 10 10 10 10 10 19 21 12 33 22 14 14 14 14 11 10 10 10 10 10 10 10 10 10 10 10 10 10 10 10 10 10 10 10 10 10 10 10 10 10 10 10 10 10 10 10 10 10 13 11 14 14 14 14 14 14 14 14 11 13
13 11 14 14 14 14 14 14 14 14 11 13 10 10 10 10 10 10 10 10 10 10 10 10 10 10 10 10 10 10 10 10 10 10 10 10 10 10 10 10 10 10 10 10 10 10 19 25 22 14 14 14 28 11 10 10 10 10 10 10 10 10 10 10 10 10 10 10 10 10 10 10 10 10 10 10 10 10 10 10 10 10 10 10 10 10 10 10 13 11 14 14 14 14 14 14 14 14 11 13
13 11 14 14 14 14 14 14 14 14 11 13 10 10 10 10 10 10 10 10 10 10 10 10 10 10 10 10 10 10 10 10 10 10 10 10 10 10 10 10 10 10 10 10 10 10 11 24 14 14 14 29 30 18 10 10 10 10 10 10 10 10 10 10 10 10 10 10 10 10 10 10 10 10 10 10 10 10 10 10 10 10 10 10 10 10 10 10 13 11 14 14 14 14 14 14 14 14 11 13
13 11 14 14 14 14 14 14 14 14 11 13 10 10 10 10 10 10 10 10 10 10 10 10 10 10 10 10 10 10 10 10 10 10 10 10 10 10 10 10 10 10 10 10 10 11 14 14 14 14 29 32 12 20 18 10 10 10 10 10 10 10 10 10 10 10 10 10 10 10 10 10 10 10 10 10 10 10 10 10 10 10 10 10 10 10 10 10 13 11 14 14 14 14 14 14 14 14 11 13
13 11 14 14 14 14 14 14 14 14 11 13 10 10 10 10 10 10 10 10 10 10 10 10 10 10 10 10 10 10 10 10 10 10 10 10 10 10 10 10 10 10 10 10 11 14 14 14 14 27 31 12 12 12 20 18 10 10 10 10 10 10 10 10 10 10 10 10 10 10 10 10 10 10 10 10 10 10 10 10 10 10 10 10 10 10 10 10 13 11 14 14 14 14 14 14 14 14 11 13
13 11 14 14 14 14 14 14 14 14 11 13 10 10 10 10 10 10 10 10 10 10 10 10 10 10 10 10 10 10 10 10 10 10 10 10 10 10 10 10 10 10 10 11 14 14 14 14 14 11 19 21 12 12 12 20 18 10 10 10 10 10 10 10 10 10 10 10 10 10 10 10 10 10 10 10 10 10 10 10 10 10 10 10 10 10 10 10 13 11 14 14 14 14 14 14 14 14 11 13
13 11 14 14 14 14 14 14 14 14 11 13 10 10 10 10 10 10 10 10 10 10 10 10 10 10 10 10 10 10 10 10 10 10 10 10 10 10 10 10 10 10 11 14 14 14 14 14 11 10 10 19 21 12 12 12 20 18 10 10 10 10 10 10 10 10 10 10 10 10 10 10 10 10 10 10 10 10 10 10 10 10 10 10 10 10 10 10 13 11 14 14 14 14 14 14 14 14 11 13
13 11 14 14 14 14 14 14 14 14 11 13 10 10 10 10 10 10 10 10 10 10 10 10 10 10 10 10 10 10 10 10 10 10 10 10 10 10 10 10 10 11 14 14 14 14 14 11 10 10 10 10 19 21 12 12 12 20 18 10 10 10 10 10 10 10 10 10 10 10 10 10 10 10 10 10 10 10 10 10 10 10 10 10 10 10 10 10 13 11 14 14 14 14 14 14 14 14 11 13
13 11 14 14 14 14 14 14 14 14 11 13 10 10 10 10 10 10 10 10 10 10 10 10 10 10 10 10 10 10 10 10 10 10 10 10 10 10 10 10 11 14 14 14 14 14 11 10 10 10 10 10 10 19 21 12 12 12 20 18 10 10 10 10 10 10 10 10 10 10 10 10 10 10 10 10 10 10 10 10 10 10 10 10 10 10 10 10 13 11 14 14 14 14 14 14 14 14 11 13
13 11 14 14 14 14 14 14 14 14 11 13 10 10 10 10 10 10 10 10 10 10 10 10 10 10 10 10 10 10 10 10 10 10 10 10 10 10 10 11 14 14 14 14 14 11 10 10 10 10 10 10 10 10 19 21 12 12 12 20 18 10 10 10 10 10 10 10 10 10 10 10 10 10 10 10 10 10 10 10 10 10 10 10 10 10 10 10 13 11 14 14 14 14 14 14 14 14 11 13
13 11 14 14 14 14 14 14 14 14 11 13 10 10 10 10 10 10 10 10 10 10 10 10 10 10 10 10 10 10 10 10 10 10 10 10 10 10 11 14 14 14 14 14 11 10 10 10 10 10 10 10 10 10 10 19 21 12 12 12 20 18 10 10 10 10 10 10 10 10 10 10 10 10 10 10 10 10 10 10 10 10 10 10 10 10 10 10 13 11 14 14 14 14 14 14 14 14 11 13
13 11 14 14 14 14 14 14 14 14 11 13 10 10 10 10 10 10 10 10 10 10 10 10 10 10 10 10 10 10 10 10 10 10 10 10 10 11 14 14 14 14 14 11 10 10 10 10 10 10 10 10 10 10 10 10 19 21 12 12 12 20 18 10 10 10 10 10 10 10 10 10 10 10 10 10 10 10 10 10 10 10 10 10 10 10 10 10 13 11 14 14 14 14 14 14 14 14 11 13
13 11 14 14 14 14 14 14 14 14 11 13 10 10 10 10 10 10 10 10 10 10 10 10 10 10 10 10 10 10 10 10 10 10 10 10 11 14 14 14 14 14 11 10 10 10 10 10 10 10 10 10 10 10 10 10 10 19 21 12 12 12 20 18 10 10 10 10 10 10 10 10 10 10 10 10 10 10 10 10 10 10 10 10 10 10 10 10 13 11 14 14 14 14 14 14 14 14 11 13
13 11 14 14 14 14 14 14 14 14 11 13 10 10 10 10 10 10 10 10 10 10 10 10 10 10 10 10 10 10 10 10 10 10 10 11 14 14 14 14 14 11 10 10 10 10 10 10 10 10 10 10 10 10 10 10 10 10 19 21 12 12 12 20 18 10 10 10 10 10 10 10 10 10 10 10 10 10 10 10 10 10 10 10 10 10 10 10 13 11 14 14 14 14 14 14 14 14 11 13
13 11 14 14 14 14 14 14 14 14 11 13 10 10 10 10 10 10 10 10 10 10 10 10 10 10 10 10 10 10 10 10 10 10 11 14 14 14 14 14 11 10 10 10 10 10 10 10 10 10 10 10 10 10 10 10 10 10 10 19 21 12 12 12 20 18 10 10 10 10 10 10 10 10 10 10 10 10 10 10 10 10 10 10 10 10 10 10 13 11 14 14 14 14 14 14 14 14 11 13
13 11 14 14 14 14 14 14 14 14 11 13 10 10 10 10 10 10 10 10 10 10 10 10 10 10 10 10 10 10 10 10 10 11 14 14 14 14 14 11 10 10 10 10 10 10 10 10 10 10 10 10 10 10 10 10 10 10 10 10 19 21 12 12 12 20 18 10 10 10 10 10 10 10 10 10 10 10 10 10 10 10 10 10 10 10 10 10 13 11 14 14 14 14 14 14 14 14 11 13
13 11 14 14 14 14 14 14 14 14 11 13 10 10 10 10 10 10 10 10 10 10 10 10 10 10 10 10 10 10 10 10 11 14 14 14 14 14 11 10 10 10 10 10 10 10 10 10 10 10 10 10 10 10 10 10 10 10 10 10 10 19 21 12 12 12 20 18 10 10 10 10 10 10 10 10 10 10 10 10 10 10 10 10 10 10 10 10 13 11 14 14 14 14 14 14 14 14 11 13
13 11 14 14 14 14 14 14 14 14 11 13 10 10 10 10 10 10 10 10 10 10 10 10 10 10 10 10 10 10 10 11 14 14 14 14 14 11 10 10 10 10 10 10 10 10 10 10 10 10 10 10 10 10 10 10 10 10 10 10 10 10 19 21 12 12 12 20 18 10 10 10 10 10 10 10 10 10 10 10 10 10 10 10 10 10 10 10 13 11 14 14 14 14 14 14 14 14 11 13
13 11 14 14 14 14 14 14 14 14 11 13 10 10 10 10 10 10 10 10 10 10 10 10 10 10 10 10 10 10 11 14 14 14 14 14 11 10 10 10 10 10 10 10 10 10 10 10 10 10 10 10 10 10 10 10 10 10 10 10 10 10 10 19 21 12 12 12 20 18 10 10 10 10 10 10 10 10 10 10 10 10 10 10 10 10 10 10 13 11 14 14 14 14 14 14 14 14 11 13
13 11 14 14 14 14 14 14 14 14 11 13 10 10 10 10 10 10 10 10 10 10 10 10 10 10 10 10 10 11 14 14 14 14 14 11 10 10 10 10 10 10 10 10 10 10 10 10 10 10 10 10 10 10 10 10 10 10 10 10 10 10 10 10 19 21 12 12 12 20 18 10 10 10 10 10 10 10 10 10 10 10 10 10 10 10 10 10 13 11 14 14 14 14 14 14 14 14 11 13
13 11 14 14 14 14 14 14 14 14 11 13 10 10 10 10 10 10 10 10 10 10 10 10 10 10 10 10 11 14 14 14 14 14 11 10 10 10 10 10 10 10 10 10 10 10 10 10 10 10 10 10 10 10 10 10 10 10 10 10 10 10 10 10 10 19 21 12 12 12 20 18 10 10 10 10 10 10 10 10 10 10 10 10 10 10 10 10 13 11 14 14 14 14 14 14 14 14 11 13
13 11 14 14 14 14 14 14 14 14 11 13 10 10 10 10 10 10 10 10 10 10 10 10 10 10 10 11 14 14 14 14 14 11 10 10 10 10 10 10 10 10 10 10 10 10 10 10 10 10 10 10 10 10 10 10 10 10 10 10 10 10 10 10 10 10 19 21 12 12 12 20 18 10 10 10 10 10 10 10 10 10 10 10 10 10 10 10 13 11 14 14 14 14 14 14 14 14 11 13
13 11 14 14 14 14 14 14 14 14 11 13 10 10 10 10 10 10 10 10 10 10 10 10 10 10 11 14 14 14 14 14 11 10 10 10 10 10 10 10 10 10 10 10 10 10 10 10 10 10 10 10 10 10 10 10 10 10 10 10 10 10 10 10 10 10 10 19 21 12 12 12 20 18 10 10 10 10 10 10 10 10 10 10 10 10 10 10 13 11 14 14 14 14 14 14 14 14 11 13
13 11 14 14 14 14 14 14 14 14 11 13 10 10 10 10 10 10 10 10 10 10 10 10 10 11 14 14 14 14 14 11 10 10 10 10 10 10 10 10 10 10 10 10 10 10 10 10 10 10 10 10 10 10 10 10 10 10 10 10 10 10 10 10 10 10 10 10 19 21 12 12 12 20 18 10 10 10 10 10 10 10 10 10 10 10 10 10 13 11 14 14 14 14 14 14 14 14 11 13
13 11 14 14 14 14 14 14 14 14 11 13 10 10 10 10 10 10 10 10 10 10 10 10 11 14 14 14 14 14 11 10 10 10 10 10 10 10 10 10 10 10 10 10 10 10 10 10 10 10 10 10 10 10 10 10 10 10 10 10 10 10 10 10 10 10 10 10 10 19 21 12 12 12 20 18 10 10 10 10 10 10 10 10 10 10 10 10 13 11 14 14 14 14 14 14 14 14 11 13
13 11 14 14 14 14 14 14 14 14 11 13 10 10 10 10 10 10 10 10 10 10 10 11 14 14 14 14 14 11 10 10 10 10 10 10 10 10 10 10 10 10 10 10 10 10 10 10 10 10 10 10 10 10 10 10 10 10 10 10 10 10 10 10 10 10 10 10 10 10 19 21 12 12 12 20 18 10 10 10 10 10 10 10 10 10 10 10 13 11 14 14 14 14 14 14 14 14 11 13
13 11 14 14 14 14 14 14 14 14 11 13 10 10 10 10 10 10 10 10 10 10 11 14 14 14 14 14 11 10 10 10 10 10 10 10 10 10 10 10 10 10 10 10 10 10 10 10 10 10 10 10 10 10 10 10 10 10 10 10 10 10 10 10 10 10 10 10 10 10 10 19 21 12 12 12 20 18 10 10 10 10 10 10 10 10 10 10 13 11 14 14 14 14 14 14 14 14 11 13
13 11 14 14 14 14 14 14 14 14 11 13 10 10 10 10 10 10 10 10 10 11 14 14 14 14 14 11 10 10 10 10 10 10 10 10 10 10 10 10 10 10 10 10 10 10 10 10 10 10 10 10 10 10 10 10 10 10 10 10 10 10 10 10 10 10 10 10 10 10 10 10 19 21 12 12 12 20 18 10 10 10 10 10 10 10 10 10 13 11 14 14 14 14 14 14 14 14 11 13
13 11 14 14 14 14 14 14 14 14 11 13 10 10 10 10 10 10 10 10 11 14 14 14 14 14 11 10 10 10 10 10 10 10 10 10 10 10 10 10 10 10 10 10 10 10 10 10 10 10 10 10 10 10 10 10 10 10 10 10 10 10 10 10 10 10 10 10 10 10 10 10 10 19 21 12 12 12 20 18 10 10 10 10 10 10 10 10 13 11 14 14 14 14 14 14 14 14 11 13
13 11 14 14 14 14 14 14 14 14 11 13 10 10 10 10 10 10 10 11 14 14 14 14 14 11 10 10 10 10 10 10 10 10 10 10 10 10 10 10 10 10 10 10 10 10 10 10 10 10 10 10 10 10 10 10 10 10 10 10 10 10 10 10 10 10 10 10 10 10 10 10 10 10 19 21 12 12 12 20 18 10 10 10 10 10 10 10 13 11 14 14 14 14 14 14 14 14 11 13
13 11 14 14 14 14 14 14 14 14 11 13 10 10 10 10 10 10 11 14 14 14 14 14 11 10 10 10 10 10 10 10 10 10 10 10 10 10 10 10 10 10 10 10 10 10 10 10 10 10 10 10 10 10 10 10 10 10 10 10 10 10 10 10 10 10 10 10 10 10 10 10 10 10 10 19 21 12 12 12 20 18 10 10 10 10 10 10 13 11 14 14 14 14 14 14 14 14 11 13
13 11 14 14 14 14 14 14 14 14 11 13 13 13 13 13 13 11 14 14 14 14 14 11 10 10 10 10 10 10 10 10 10 10 10 10 10 10 10 10 10 10 10 10 10 10 10 10 10 10 10 10 10 10 10 10 10 10 10 10 10 10 10 10 10 10 10 10 10 10 10 10 10 10 10 10 19 21 12 12 12 20 18 10 10 10 10 10 13 11 14 14 14 14 14 14 14 14 11 13
11 11 16 16 16 16 16 16 16 16 11 11 11 11 11 11 11 14 14 14 14 14 11 10 10 10 10 10 10 10 10 10 10 10 10 10 10 10 10 10 10 10 10 10 10 10 10 10 10 10 10 10 10 10 10 10 10 10 10 10 10 10 10 10 10 10 10 10 10 10 10 10 10 10 10 10 10 19 21 12 12 12 20 18 10 10 10 10 13 11 14 14 14 14 14 14 14 14 11 13
11 16 16 16 16 16 16 16 16 16 16 16 16 16 16 16 16 16 16 14 14 11 10 10 10 10 10 10 10 10 10 10 10 10 10 10 10 10 10 10 10 10 10 10 10 10 10 10 10 10 10 10 10 10 10 10 10 10 10 10 10 10 10 10 10 10 10 10 10 10 10 10 10 10 10 10 10 10 19 21 12 12 12 20 18 10 10 10 13 11 14 14 14 14 14 14 14 14 11 13
11 16 16 16 16 16 16 16 16 16 16 16 16 16 16 16 16 16 16 14 11 10 10 10 10 10 10 10 10 10 10 10 10 10 10 10 10 10 10 10 10 10 10 10 10 10 10 10 10 10 10 10 10 10 10 10 10 10 10 10 10 10 10 10 10 10 10 10 10 10 10 10 10 10 10 10 10 10 10 19 21 12 12 12 20 18 10 10 13 11 14 14 14 14 14 14 14 14 11 13
11 16 16 16 16 16 16 16 16 16 16 16 16 16 16 16 16 16 16 11 13 10 10 10 10 10 10 10 10 10 10 10 10 10 10 10 10 10 10 10 10 10 10 10 10 10 10 10 10 10 10 10 10 10 10 10 10 10 10 10 10 10 10 10 10 10 10 10 10 10 10 10 10 10 10 10 10 10 10 10 19 21 12 12 12 20 18 10 13 11 14 14 14 14 14 14 14 14 11 13
11 16 16 16 16 16 16 16 16 16 16 16 16 16 16 16 16 16 16 11 13 10 10 10 10 10 10 10 10 10 10 10 10 10 10 10 10 10 10 10 10 10 10 10 10 10 10 10 10 10 10 10 10 10 10 10 10 10 10 10 10 10 10 10 10 10 10 10 10 10 10 10 10 10 10 10 10 10 10 10 10 19 21 12 12 12 20 18 13 11 14 14 14 14 14 14 14 14 11 13
11 16 16 16 16 16 16 16 16 16 16 16 16 16 16 16 16 16 16 11 13 10 10 10 10 10 10 10 10 10 10 10 10 10 10 10 10 10 10 10 10 10 10 10 10 10 10 10 10 10 10 10 10 10 10 10 10 10 10 10 10 10 10 10 10 10 10 10 10 10 10 10 10 10 10 10 10 10 10 10 10 10 19 21 12 12 12 20 18 11 14 14 14 14 14 14 14 14 11 13
11 16 16 16 16 16 16 16 16 16 16 16 16 16 16 16 16 16 16 11 13 10 10 10 10 10 10 10 10 10 10 10 10 10 10 10 10 10 10 10 10 10 10 10 10 10 10 10 10 10 10 10 10 10 10 10 10 10 10 10 10 10 10 10 10 10 10 10 10 10 10 10 10 10 10 10 10 10 10 10 10 10 10 19 21 12 12 12 20 18 14 14 14 14 14 14 14 14 11 13
11 16 16 16 16 16 16 16 16 16 16 16 16 16 16 16 16 16 16 11 13 10 10 10 10 10 10 10 10 10 10 10 10 10 10 10 10 10 10 10 10 10 10 10 10 10 10 10 10 10 10 10 10 10 10 10 10 10 10 10 10 10 10 10 10 10 10 10 10 10 10 10 10 10 10 10 10 10 10 10 10 10 10 10 19 21 12 12 12 20 14 14 14 14 14 14 14 14 11 13
11 16 16 16 16 16 16 16 16 16 16 16 16 16 16 16 16 16 16 11 13 13 13 13 13 13 13 13 13 13 13 13 13 13 13 13 13 13 13 13 13 13 13 13 13 13 13 13 13 13 13 13 13 13 13 13 13 13 13 13 13 13 13 13 13 13 13 13 13 13 13 13 13 13 13 13 13 13 13 13 13 13 13 13 13 19 21 12 12 12 14 14 14 14 14 14 14 14 11 13
11 16 16 16 16 16 16 16 16 16 16 16 16 16 16 16 16 16 16 11 11 11 11 11 11 11 11 11 11 11 11 11 11 11 11 11 11 11 11 11 11 11 11 11 11 11 11 11 11 11 11 11 11 11 11 11 11 11 11 11 11 11 11 11 11 11 11 11 11 11 11 11 11 11 11 11 11 11 11 11 11 11 11 11 11 11 19 21 12 12 14 14 14 14 14 14 14 14 11 13
11 16 16 16 16 16 16 16 16 16 16 16 16 16 16 16 16 16 16 16 14 14 14 14 14 14 14 14 14 14 14 14 14 14 14 14 14 14 14 14 14 14 14 14 14 14 14 14 14 14 14 14 14 14 14 14 14 14 14 14 14 14 14 14 14 14 14 14 14 14 14 14 14 14 14 14 14 14 14 14 14 14 14 14 14 14 14 14 14 14 14 14 14 14 14 14 14 14 11 13
11 16 16 16 16 16 16 16 16 16 16 16 16 16 16 16 16 16 16 16 14 14 14 14 14 14 14 14 14 14 14 14 14 14 14 14 14 14 14 14 14 14 14 14 14 14 14 14 14 14 14 14 14 14 14 14 14 14 14 14 14 14 14 14 14 14 14 14 14 14 14 14 14 14 14 14 14 14 14 14 14 14 14 14 14 14 14 14 14 14 14 14 14 14 14 14 14 14 11 13
11 16 16 16 16 16 16 16 16 16 16 16 16 16 16 16 16 16 16 16 14 14 14 14 14 14 14 14 14 14 14 14 14 14 14 14 14 14 14 14 14 14 14 14 14 14 14 14 14 14 14 14 14 14 14 14 14 14 14 14 14 14 14 14 14 14 14 14 14 14 14 14 14 14 14 14 14 14 14 14 14 14 14 14 14 14 14 14 14 14 14 14 14 14 14 14 14 14 11 13
11 16 16 16 16 16 16 16 16 16 16 16 16 16 16 16 16 16 16 16 14 14 14 14 14 14 14 14 14 14 14 14 14 14 14 14 14 14 14 14 14 14 14 14 14 14 14 14 14 14 14 14 14 14 14 14 14 14 14 14 14 14 14 14 14 14 14 14 14 14 14 14 14 14 14 14 14 14 14 14 14 14 14 14 14 14 14 14 14 14 14 14 14 14 14 14 14 14 11 13
11 16 16 16 16 16 16 16 16 16 16 16 16 16 16 16 16 16 16 16 14 14 14 14 14 14 14 14 14 14 14 14 14 14 14 14 14 14 14 14 14 14 14 14 14 14 14 14 14 14 14 14 14 14 14 14 14 14 14 14 14 14 14 14 14 14 14 14 14 14 14 14 14 14 14 14 14 14 14 14 14 14 14 14 14 14 14 14 14 14 14 14 14 14 14 14 14 14 11 13
11 16 16 16 16 16 16 16 16 16 16 16 16 16 16 16 16 16 16 16 14 14 14 14 14 14 14 14 14 14 14 14 14 14 14 14 14 14 14 14 14 14 14 14 14 14 14 14 14 14 14 14 14 14 14 14 14 14 14 14 14 14 14 14 14 14 14 14 14 14 14 14 14 14 14 14 14 14 14 14 14 14 14 14 14 14 14 14 14 14 14 14 14 14 14 14 14 14 11 13
11 16 16 16 16 16 16 16 16 16 16 16 16 16 16 16 16 16 16 16 14 14 14 14 14 14 14 14 14 14 14 14 14 14 14 14 14 14 14 14 14 14 14 14 14 14 14 14 14 14 14 14 14 14 14 14 14 14 14 14 14 14 14 14 14 14 14 14 14 14 14 14 14 14 14 14 14 14 14 14 14 14 14 14 14 14 14 14 14 14 14 14 14 14 14 14 14 14 11 13
11 16 16 16 16 16 16 16 16 16 16 16 16 16 16 16 16 16 16 16 14 14 14 14 14 14 14 14 14 14 14 14 14 14 14 14 14 14 14 14 14 14 14 14 14 14 14 14 14 14 14 14 14 14 14 14 14 14 14 14 14 14 14 14 14 14 14 14 14 14 14 14 14 14 14 14 14 14 14 14 14 14 14 14 14 14 14 14 14 14 14 14 14 14 14 14 14 14 11 13
11 16 16 16 16 16 16 16 16 16 16 16 16 16 16 16 16 16 16 16 11 11 11 11 11 11 11 11 11 11 11 11 11 11 11 11 11 11 11 11 11 11 11 11 11 11 11 11 11 11 11 11 11 11 11 11 11 11 11 11 11 11 11 11 11 11 11 11 11 11 11 11 11 11 11 11 11 11 11 11 11 11 11 11 11 11 11 11 11 11 11 11 11 11 11 11 11 11 11 13
11 11 11 11 11 11 11 11 11 11 11 11 11 11 11 11 11 11 11 11 13 13 13 13 13 13 13 13 13 13 13 13 13 13 13 13 13 13 13 13 13 13 13 13 13 13 13 13 13 13 13 13 13 13 13 13 13 13 13 13 13 13 13 13 13 13 13 13 13 13 13 13 13 13 13 13 13 13 13 13 13 13 13 13 13 13 13 13 13 13 13 13 13 13 13 13 13 13 13 13